$name=Level 3
$background=graphics/background_dark.png
$time=200
M                            LM                                                                                                                                                                   LM   LM          LM                                                                              L
M                            LM                                                                                                                                                                   LM   LM          LM                                                       o                      L
Mo                           LM                                                                                                                                                                   LM   LMoo        LM                                                                             oL
Mo         oo                LM    RQ                                                                                                                                                             LM   LM         oLM      xx                      VU    s    VU                     b             L
Mo                           LM    LM o g o RQ                                                                                                                         xxxxx                      LM   LM         oLM                                VUxxfxxVU                       RQ            L
M                            LM    LPKKKKKKKSM                         xxxxxxx                                                                                                                    LMoooLM         oLM              RQ                                 g              LM            L
M                            LMo   LZNNNNNNNNY                                                                             RQ                                                                     LMoooLM         oLM   s     s    LM                                                LM s o s RQ   L
PQ                 VU        LPQ   LM                                                                                      LM                                VU    s   s    s   s    VU           LMoooLM         RSPKKKKKKKKKKKKKKSM            VU  s oooo       s  VU              LPKKKKKKKSM   L
ZY         RQ                ONY   LM               oo             g             g                                         LM      RQ                          VWWWWWWWWWWWWWWWWWWWWU             LMoooLM  f      ONNNNNNNNNNNNNNNNNY   o  RQ      VWWWWWWWWWWWWWWWWU       X        ONNNNNNNNNY   L
M     k    LM                      LM               RQ             RKKKKQxfxRKKKKQ                                         LM   s  LM                                                             LM   LM                 oo         X ooo OY                                                      L
M     X    LM                      LM               LM    VWWWWU   ONNNNY   ONNNNY   VWWWWU                               RSPKKKKKKSM          RQ                                                 OY   OY                               o                                                         RS
M          LM                     RSM               LM              o o o o o o o                                         LZNNNNNNNNY          LM       X                                                                                                                                         LJ
M         gLM                     LJM               LM                                                                    LM                   LM                                             RQ                          RQ                                                                      LJ
M    s     LM               RQ  s LJM               LM    s oo s          s          s oo s     RQ      o      T s  T     LM   s s s  ogogogo oLM                                             LM g s                   s  LM    s  s  RQ                                             RQ     s     LJ
PKKKKKKKKKKSM               LPKKKKSJM               LPKKKKKKKKKKKKKKKKKKKKKKKKSPKKKKKKKKKKKKKKKKSM      T      2KKKK1     LPKKKKKKKKKKKKKKKKKKKSM                                             LPKKKKKKKKKKKKKKKKKKKKKKKKKKSPKKKKKKKKKKSM                                             LPKKKKKKKKKKKSJ